MMMMMDMM
M      M
M MMMM M
M MSM  M
M M MM M
M M M  M
M      M
MMMMMMMM